wwwwwww
w-----w
w--p--w
w-----w
ww-^-ww
www--ww
www--ww
wwwwwww