^^^^^^^^^^^^^^^
^-----p-------^
^-------------^
^-------------^
^-------------^
^------------D^
^^^^^^^^^^^^^^^