wwwwwwwwwwwwwww
w-------p-----w
w-------------w
w-------------w
w-------------w
w-------D-----w
^^^^^^^^^^^^^^^