wwwwwwwwwwwwwwww
w--------------w
w-------p------w
w--------------w
w--^--------^--w
w-------^------w
w--------------w
w---D----------w
wwwwwwwwwwwwwwww